###################################################################################################
#.................................................................................................#
#.................................................................................................#
#.................................................................................................#
#.................................................................................................#
#.................................................................................................#
#.................................................................................................#
#.................................................................................................#
#.................................................................................................#
#.................................................................................................#
#.................................................................................................#
#.................................................................................................#
#.................................................................................................#
#.................................................................................................#
#.................................................................................................#
#.................................................................................................#
#........................#####....................................................................#
#........................#...#....................................................................#
#........................#...#....................................................................#
#........................#####....................................................................#
#.................................................................................................#
#.................................................................................................#
#.................................................................................................#
#.................................................................................................#
#.................................................................................................#
#.................................................................................................#
#.................................................................................................#
#.................................................................................................#
#.................................................................................................#
#.................................................................................................#
#.................................................................................................#
#.................................................................................................#
#.................................................................................................#
#.................................................................................................#
#.................................................................................................#
#.................................................................................................#
#.................................................................................................#
#.................................................................................................#
#.................................................................................................#
#.................................................................................................#
#.................................................................................................#
#.................................................................................................#
#.................................................................................................#
#.................................................................................................#
#.................................................................................................#
#.................................................................................................#
#.................................................................................................#
#.................................................................................................#
#.................................................................................................#
###################################################################################################


