000000000000000000000000000000000000000000000000000000000000000000000000000000000000000000000000000
YYYYYYYYYYYYYYYYYYYYYYYYYYYYYYYYYYYYYYYYYYYYYYYYYYYYYYYYYYYYYYYYYYYYYYYYYYYYYYYYYYYYYYYYYYYYYYYYYYY
000000000000000000000000000000000000000000000000000000000000000000000000000000000000000000000000000
YYYYYYYYYYYYYYYYYYYYYYYYYYYYYYYYYYYYYYYYYYYYYYYYYYYYYYYYYYYYY..............YYYYYYYYYYYYYYYYYYYYYYYY
000000000000000000000000000000000000000~~~~~~~~~~~~~~~~~~..........................................
YYYYYYYYYYYYYYYYYYYYYYYYYYYYYYYYYYYYYYY~~~~~~~~~...................................................
0000000000000000000000000000000000~~~~~~~~~~~.........................,,,,,|,,|0000000000000.......
YYYYYYYYYYYYYYYYYYYYYYYYYYYYY000~~~~~~~~....................,,,,,|,,,|,,|,,,,,,YYYYYYYYYYYYY.......
00000000000000000000000000000000000000~~...................,,,,,,|,,|,,|,,,,|,,|0000000000000000000
YYYYYYYYYYYYYYYYYYYYYYYYYYYYYYYYYYYY000....................,,,|,,|,,|,|,,|,,,,,,YYYYYYYYYYYYYYYYYYY
000000000000000000000000000000000000000000...............,,,|,,,|,,..,,||,|,|0000000000000000000000
YYYYYYYYYYYYYYYYYYYYYYYYYYYYYYYYYYYYYYYYYY...............,,,|,,,|,,|.,,|,|,,,YYYYYYYYYYYYYYYYYYYYYY
000000000000000000000000000000000000000000000000,,|,,,,,,,,,|,,|,,,,|,,,,00000000000000000000000000
YYYYYYYYYYYYYYYYYYYYYYYYYYYYYYYYYYYYYYYYYYYYYYYY,,|,,|,,,,,,,|,,|,,,,|,,|YYYYYYYYYYYYYYYYYYYYYYYYYY
0000000000000000000000000000000000000000000000,,,|,,,|,,,|,,,|,,|,,|,,,0000000000000000000000000000
YYYYYYYYYYYYYYYYYYYYYYYYYYYYYYYYYYYYYYYYYYYY,,,,,,,,,|,,,|,,|,,|,,.....YYYYYYYYYYYYYYYYYYYYYYYYYYYY
00000000000000000000000000000000000000~~~~~~..........................,|,00000000000000000000000000
YYYYYYYYYYYYYYYYYYYYYYYYYYY~~~~~~~~~~~~~~~~..........................,|,|YYYYYYYYYYYYYYYYYYYYYYYYYY 
000000000000000000000000000~~~~~~~~~~~~~............................,|.,,00000000000000000000000000
YYYYYYYYYYYYYYYYYYYYYYYY............................................,|,,|YYYYYYYYYYYYYYYYYYYYYYYYYY
0000000,|,|,|,|,|,||............................................,,|,,|,|,,,|00000000000000000000000
YYYYYYY000.,,,|,|,,,|,,|,|,,YYYYYYYYYYYY00......................,|,,,.,|,,|,YYYYYYYYYYYYYYYYYYYYYYY
00000000000000000000000000000000000000000000000~~~,|,,,|,,,|||,,,,|,,,|,,00000000000000000000000000
YYYYYYYYYYYYYYYYYYYYYYYYYYYYYYYYYYYYYYYYYYYYYYY~~~~~,,|,,,|,,|,,,|,,,|,,|YYYYYYYYYYYYYYYYYYYYYYYYYY
0000000000000000000000000000000000000000000000000000,,,|,,,|||,,,,|,,,|,,00000000000000000000000000
YYYYYYYYYYYYYYYYYYYYYYYYYYYYYYYYYYYYYYYYYYYYYYYYYYYY,,|,,,|,,|,,,|,,,|,,|YYYYYYYYYYYYYYYYYYYYYYYYYY
000000000000000000000000000000000000000000000000000000000,|,...............000000000000000000000000
YYYYYYYYYYYYYYYYYYYYYYYYYYYYYYYYYYYYYYYYYYYYYYYYYYYYYYY....................YYYYYYYYYYYYYYYYYYYYYYYY
00000000000000000000000000............................................,,,,,|,,000000000000000000000
YYYYYYYYYYYYYYYYYYYYYYYYYY.....................................,,,,,|,,||,,,||YYYYYYYYYYYYYYYYYYYYY
0000000000000000000000......................,|,|,,,|,,,,,|,|,|,,,,,|,,,0000000000000000000000000000
YYYYYYYYYYYYYYYYYYYYYY..................,|,|,,,,|,|,|,|,|,,,,,|,~~~~~~YYYYYYYYYYYYYYYYYYYYYYYYYYYYY
000000000000000000000000...............,|,|00000000000000000000000000000000000000000000000000000000 
YYYYYYYYYYYYYYYYYYYYYYYY...................YYYYYYYYYYYYYYYYYYYYYYYYYYYYYYYYYYYYYYYYYYYYYYYYYYYYYYYY
000000000000000000.........................00000000000000000000000000000000000000000000000000000000
YYYYYYYYYYYYYYYYYY.........................YYYYYYYYYYYYYYYYYYYYYYYYYYYYYYY~~~YYYYYYYYYYYYYYYYYYYYYY
00000000000000.........................................................~~~~~~0000000000000000000000
YYYYYYYYYYYYYY...........................................................~~~~YYYYYYYYYYYYYYYYYYYYYY
0000......................................................................~~~0000000000000000000000
YYYY.........................................................................YYYYYYYYYYYYYYYYYYYYYY
0000000............................................................................................
YYYYYYY............................................................................................
000000..............................................................0000000000000000000000000000000
YYYYYY..............................................................YYYYYYYYYYYYYYYYYYYYYYYYYYYYYYY
0000.............................................................00000000000000000000000000000000000
YYYY.. .........................................................YYYYYYYYYYYYYYYYYYYYYYYYYYYYYYYYYYY
0000000...................................................00000000000000000000000000000000000000000
YYYYYYY...................................................YYYYYYYYYYYYYYYYYYYYYYYYYYYYYYYYYYYYYYYYY
000000000000000000000000000000000000000000000000000000000000000000000000000000000000000000000000000
YYYYYYYYYYYYYYYYYYYYYYYYYYYYYYYYYYYYYYYYYYYYYYYYYYYYYYYYYYYYYYYYYYYYYYYYYYYYYYYYYYYYYYYYYYYYYYYYYYY