000000000000000000000000000000000000000000000000000000000000000000000000000000000000000000000000000
YYYYYYYYYYYYYYYYYYYYYYYYYYYYYYYYYYYYYYYYYYYYYYYYYYYYYYYYYYYYYYYYYYYYYYYYYYYYYYYYYYYYYYYYYYYYYYYYYYY
000000000000000000000000000000000000000000000000000000000000000000000000000000000000000000000000000
YYYYYYYYYYYYYYYYYYYYYYYYYYYYYYYYYYYYYYYYYYYYYYYYYYYYYYYYYYYYYYYYYYYYYYYYYYYYYYYYYYYYYYYYYYYYYYYYYYY
000000000000000000000000000000000000000000000000000000000000000000000000000000000000000000000000000
YYYYYYYYYYYYYYYYYYYYYYYYYYYYYYYYYYYYYYYYYYYYYYYYYYYYYYYYYYYYYYYYYYYYYYYYYYYYYYYYYYYYYYYYYYYYYYYYYYY
000000000000000000000000000000000000000000000000000000000000000000000000000000000000000000000000000
YYYYYYYYYYYYYYYYYYYYYYYYYYYYYYYYYYYYYYYYYYYYYYYYYYYYYYYYYYYYYYYYYYYYYYYYYYYYYYYYYYYYYYYYYYYYYYYYYYY
000000000000000000000000000000000000000000000000000000000000000000000000000000000000000000000000000
YYYYYYYYYYYYYYYYYYYYYYYYYYYYYYYYYYYYYYYYYYYYYYYYYYYYYYYYYYYYYYYYYYYYYYYYYYYYYYYYYYYYYYYYYYYYYYYYYYY
000000000000000000000000000000000000000000000000000000000000000000000000000000000000000000000000000
YYYYYYYYYYYYYYYYYYYYYYYYYYYYYYYYYYYYYYYYYYYYYYYYYYYYYYYYYYYYYYYYYYYYYYYYYYYYYYYYYYYYYYYYYYYYYYYYYYY
000000000000000000000000000000000000000000000000000000000000000000000000000000000000000000000000000
YYYYYYYYYYYYYYYYYYYYYYYYYYYYYYYYYYYYYYYYYYYYYYYYYYYYYYYYYYYYYYYYYYYYYYYYYYYYYYYYYYYYYYYYYYYYYYYYYYY
000000000000000000000000000000000000000000000000000000000000000000000000000000000000000000000000000
YYYYYYYYYYYYYYYYYYYYYYYYYYYYYYYYYYYYYYYYYYYYYYYYYYYYYYYYYYYYYYYYYYYYYYYYYYYYYYYYYYYYYYYYYYYYYYYYYYY
000000000000000000000000000000000000000000000000000000000000000000000000000000000000000000000000000
YYYYYYYYYYYYYYYYYYYYYYYYYYYYYYYYYYYYYYYYYYYYYYYYYYYYYYYYYYYYYYYYYYYYYYYYYYYYYYYYYYYYYYYYYYYYYYYYYYY
000000000000000000000000000000000000000000000000000000000000000000000000000000000000000000000000000
YYYYYYYYYYYYYYYYYYYYYYYYYYYYYYYYYYYYYYYYYYYYYYYYYYYYYYYYYYYYYYYYYYYYYYYYYYYYYYYYYYYYYYYYYYYYYYYYYYY
000000000000000000000000000000000000000000000000000000000000000000000000000000000000000000000000000
YYYYYYYYYYYYYYYYYYYYYYYYYYYYYYYYYYYYYYYYYYYYYYYYYYYYYYYYYYYYYYYYYYYYYYYYYYYYYYYYYYYYYYYYYYYYYYYYYYY
000000000000000000000000000000000000000000000000000000000000000000000000000000000000000000000000000
YYYYYYYYYYYYYYYYYYYYYYYYYYYYYYYYYYYYYYYYYYYYYYYYYYYYYYYYYYYYYYYYYYYYYYYYYYYYYYYYYYYYYYYYYYYYYYYYYYY
000000000000000000000000000000000000000000000000000000000000000000000000000000000000000000000000000
YYYYYYYYYYYYYYYYYYYYYYYYYYYYYYYYYYYYYYYYYYYYYYYYYYYYYYYYYYYYYYYYYYYYYYYYYYYYYYYYYYYYYYYYYYYYYYYYYYY
000000000000000000000000000000000000000000000000000000000000000000000000000000000000000000000000000
YYYYYYYYYYYYYYYYYYYYYYYYYYYYYYYYYYYYYYYYYYYYYYYYYYYYYYYYYYYYYYYYYYYYYYYYYYYYYYYYYYYYYYYYYYYYYYYYYYY
000000000000000000000000000000000000000000000000000000000000000000000000000000000000000000000000000
YYYYYYYYYYYYYYYYYYYYYYYYYYYYYYYYYYYYYYYYYYYYYYYYYYYYYYYYYYYYYYYYYYYYYYYYYYYYYYYYYYYYYYYYYYYYYYYYYYY
,,,,|,,,,|,,|,,,|,,,|,,|z,|,,|,|,,|0000000000000000000000000000000000000000000000000000000000000000
,,,,|,,,|,,,,|,,,,,,,,,,|,,,,,,,,|,YYYYYYYYYYYYYYYYYYYYYYYYYYYYYYYYYYYYYYYYYYYYYYYYYYYYYYYYYYYYYYYY
,,|,,,,,,|,,,|,,,,|||||,,,,,,|,,,,|,,,|000000000000000000000000000000000000000000000000000000000000
|,,,,,,,,,,,||,,|,,|,,,|,,,|,,|,,|,,,|,YYYYYYYYYYYYYYYYYYYYYYYYYYYYYYYYYYYYYYYYYYYYYYYYYYYYYYYYYYYY
,,,,,,,,,,|||,,,,,,|,,,,,,|,,,|,,||,,,........00000000000000000000000000000000000000000000000000000
,,,,,,||,,,,,,,|,,,,,||,,|,,,,,,,|,,..........YYYYYYYYYYYYYYYYYYYYYYYYYYYYYYYYYYYYYYYYYYYYYYYYYYYYY
|,,,,,|,,,,|,,,,,,,|,,,,,,,|,,,,...........................0000000000000000000000000000000000000000
,,,,,,,,,,|,,,,,|,,,|,.....................................YYYYYYYYYYYYYYYYYYYYYYYYYYYYYYYYYYYYYYYY
,,,|,,,,,|,,,,,,......................................................00000000000000000000000000000
,,,,,,,|,,,|,,........................................................YYYYYYYYYYYYYYYYYYYYYYYYYYYYY
|,,,,|,,,,|,,...................................................................0000000000000000000
,,,,,,,,|.......................................................................YYYYYYYYYYYYYYYYYYY
|,,,,,..........................................................................0000000000000000000
,,,,...................................................................,,,,||,,|YYYYYYYYYYYYYYYYYYY 
,,....~~~~~~~~~~~~~~~~~~~~~~~~~~~~~~~~~~~~~~~~~~~~~~~~~~~~~~~~~~~~~~~,,,,||,|,,,,|,,|,,,,0000000000
~~~~~~~~~~~~~~~~~~~~~~~~~~~~~~~~~~~~~~~~~~~~~~~~~~~~~~~~~~~~~~~~~~~~~,,,|,,,|,,|,,,,,,|,,YYYYYYYYYY
~~~~~~~~~~~~~~~~~~~~~~~~~~~~~~~~~~~~~~~~~~~~~~~~~~~~~~~~~~~~~~~~~~~,,,,,,|,,,,|,,,,|,,,,,0000000000
~~~~~~~~~~~~~~~~~~~~~~~~~~~~~~~~~~~~~~~~~~~~~~~~~~~~~~~~~~~~~~~~~~,,,|,,,|,,,|,,,|,,|,,,,YYYYYYYYYY
~~~~~~~~~~~~~~~~~~~~~~~~~~~~~~~~~~~~~~~~~~~~~~~~~~~~~~~~~~~~~,,,,,,,,,,,,,|||,,|,,,|,,,|,YYYYYYYYYY
~~~~~~~~~~~~~~~~~~~~~~~~~~~~~~~~~~~~~~~~~~~~~~~~~~~~~~~~~~~~~~~~~~~~~~~~~~~~~~~~~~~~~~~~~~~~~~~~~~~